[
  {
    "type": "mapgen",
    "method": "json",
    "om_terrain": [ "cave_underground_innawood" ],
    "weight": 500,
    "object": {
      "fill_ter": "t_dirt_underground",
      "rows": [
        "........................",
        "........................",
        "...........!!!!!!.......",
        ".........!!!!!!!!!......",
        ".........!!!!!!!!!......",
        ".........!!!!!!!!!......",
        ".......!!!,,,,,,!.......",
        "........!!!!..,,,!......",
        ".........!!,..,,,!!.....",
        "..........,,,,,,,!......",
        "..........,,,,,,,.......",
        "..........,,,,,,,.......",
        "..........,,,,,,,.......",
        ".........,,,,.,,,.......",
        ".........,,,,...,.......",
        ".........,,,,...,.......",
        ".........,,,,...,.......",
        ".........,,,,...,.......",
        ".........,,,,...,.......",
        ".........,,,,..,,.......",
        ".........,,,..,,........",
        "..........,,.,,.........",
        "...........,>,..........",
        "........................"
      ],
      "terrain": { ".": "t_soil", ",": "t_dirt_underground", ">": "t_slope_up" },
      "items": { "!": { "item": "cave_minerals", "chance": 100, "repeat": [ 1, 3 ] } },
      "furniture": {  }
    }
  }
]
