[
  {
    "type": "mapgen",
    "method": "json",
    "om_terrain": [ "cave_underground_innawood" ],
    "weight": 500,
    "object": {
      "fill_ter": "t_dirt_underground",
      "rows": [
        "........................",
        ".......         m ......",
        ".....m    mmmm     .....",
        ".....    mmmmmm    .....",
        "....m   m------m    ....",
        "...    m-%%%%%%-m   m...",
        "...   m-%%~~~~%%-m   ...",
        "...m m-%%~~~~~~%%-m m...",
        "...  m-%%~~~~~~%%-m  ...",
        "...   m-%%~~~~%%-m  m...",
        "...m   m-%%%%%%-m    ...",
        "....    m------m    ....",
        ".....    mmmmmm    m....",
        "......            m.....",
        ".......m        mm......",
        ".......           ......",
        "........        m.......",
        ".........       ........",
        "...........   ..........",
        "...........   ..........",
        "...........   ..........",
        "...........   ..........",
        "............<...........",
        "........................"
      ],
      "terrain": {
        ".": "t_soil",
        " ": "t_dirt_underground",
        "<": "t_slope_up",
        "~": "t_water_hot",
        "m": "t_dirt_underground",
        "%": [ [ "t_water_hot", 3 ], "t_dirt_underground", 1 ],
        "-": [ [ "t_water_hot", 1 ], "t_dirt_underground", 2 ]
      },
      "furniture": { "m": [ [ "f_corpsefire_mushroom", 1 ], [ "f_null", 8 ] ] },
      "items": { "1": { "item": "cave_minerals", "chance": 40, "repeat": [ 1, 3 ] } },
      "monsters": { " ": { "monster": "GROUP_CAVE", "chance": 2 } }
    }
  },
  {
    "type": "mapgen",
    "method": "json",
    "om_terrain": [ "cave_underground_innawood" ],
    "weight": 300,
    "object": {
      "fill_ter": "t_dirt_underground",
      "rows": [
        "........................",
        "...mmm  ..1    .....mmm.",
        ".......    ...      m...",
        "....    ............ ...",
        ".... ............... ...",
        ".... ........www ... 1..",
        "....   .........  ... ..",
        "...... 1.........1    ..",
        ".......ww.wwww....... ..",
        ".ww ....wwwwww....... ..",
        "...1   ww.wwwwww .... ..",
        "....  ....wwww.. .... ..",
        "..   ........... .... ..",
        ".. ......   ....  ..  ..",
        ".. .....  .  .... .. ...",
        ".. ....  ...  www .. ...",
        "..  ... ............ ...",
        "...  ..1..........  1...",
        "....      .....    .....",
        ".....1...     . ..  ....",
        ".... ........  ....   ..",
        "...ww....... ........ ..",
        "...w........<......w  ..",
        "..................ww...."
      ],
      "terrain": { ".": "t_soil", " ": "t_dirt_underground", "w": "t_dirt_underground", "<": "t_slope_up" },
      "furniture": { "m": [ [ "f_corpsefire_mushroom", 4 ], [ "f_null", 4 ] ] },
      "items": { "1": { "item": "wasp_lair", "chance": 40, "repeat": [ 1, 3 ] } },
      "monster": { "w": { "monster": "mon_dark_wyrm", "chance": 5 } }
    }
  }
]
