[
  {
    "type": "mapgen",
    "method": "json",
    "om_terrain": "myst_standing_stones",
    "object": {
      "fill_ter": "t_grass",
      "rows": [
        "........................",
        "........................",
        "........................",
        "........................",
        "..........S,S...........",
        "........S,,,,,S.........",
        "......S,,,S,S,,,S.......",
        "......,,,,,,,,,,,.......",
        ".....S,,,S,,,S,,,S......",
        ".....,,,,,,S,,,,,,......",
        "....S,,,S,mmm,S,,,S.....",
        ".....,,,,,mAm,,,,,......",
        "....S,,,S,mmm,S,,,S.....",
        ".....,,,,,,S,,,,,,......",
        ".....S,,,S,,,S,,,S......",
        "......,,,,,,,,,,,.......",
        "......S,,,S,S,,,S.......",
        "........S,,,,,S.........",
        "..........S,S...........",
        "........................",
        "........................",
        "........................",
        "........................",
        "........................"
      ],
      "terrain": {
        ",": [ [ "t_moss", 50 ], [ "t_grass", 25 ], [ "t_dirt", 25 ] ],
        "S": [ [ "t_moss", 50 ], [ "t_grass", 25 ], [ "t_dirt", 25 ] ],
        ".": [ [ "t_grass", 25 ], [ "t_dirt", 25 ] ],
        "m": [ [ "t_moon_ground", 100 ] ],
        "A": [ [ "t_moon_ground", 100 ] ]
      },
      "furniture": { "S": [ [ "f_myst_standing_stone", 65 ], [ "f_rubble_rock", 35 ] ], "A": "f_moon_altar" }
    }
  }
]
