[
  {
    "type": "mapgen",
    "method": "json",
    "om_terrain": [ "mound_base_NW", "mound_base_NE", "mound_base_SW", "mound_base_SE" ],
    "object": {
      "fill_ter": [ "t_grass" ],
      "rotation": [ 0, 3 ],
      "rows": [
        "................................................",
        ".....................|||||||||||................",
        "................|||||||||||||||||||.............",
        "............||||||||||||||||||||||||............",
        ".........|||||||||||||||||||||||||||||..........",
        "........|||||||||||||||||||||||||||||||.........",
        ".......|||||||||||||||||||||||||||||||||........",
        "......|||||||||||||||||||||||||||||||||||.......",
        ".....||||||||||||||||||||||||||||||||||||.......",
        ".....|||||||||||||||||||||||||||||||||||||......",
        "....||||||||||||||||||||||||||||||||||||||......",
        "...||||||||||||||||||||||||||||||||||||||||.....",
        "...|||||||||||||||||||||||||||||||||||||||||....",
        "..||||||||||||||||||||||||||||||||||||||||||....",
        "..|||||||||||||||||||||||||||||||||||||||||||...",
        "..|||||||||||||||||||||||||||||||||||||||||||...",
        ".||||||||||||||||||||||||||||||||||||||||||||...",
        ".|||||||||||||||||||||||||||||||||||||||||||||..",
        ".|||||||||||||||||||||||,,||||||||||||||||||||..",
        ".|||||||||||||||||||||,,,,,,|||||||||||||||||||.",
        ".||||||||||||||||||||,,,,,,,,||||||||||||||||||.",
        ".|||||||||||||||||||,,,,,,,,,,|||||||||||||||||.",
        ".|||||||||||||||||||,,,,,,,,,,|||||||||||||||||.",
        ".||||||||||||||||||,,,,,,,,,,,,,,,,,,,,,,,,,,bb.",
        ".||||||||||||||||||,,,,,,,,,,,,,,,,,,,,,,,,,,bb.",
        ".|||||||||||||||||||,,,,,,,,,,|||||||||||||||||.",
        ".|||||||||||||||||||,,,,,,,,,,|||||||||||||||||.",
        "..|||||||||||||||||||,,,,,,,,||||||||||||||||||.",
        "..||||||||||||||||||||,,,,,,|||||||||||||||||||.",
        "..||||||||||||||||||||||,,||||||||||||||||||||..",
        "..||||||||||||||||||||||||||||||||||||||||||||..",
        "...|||||||||||||||||||||||||||||||||||||||||||..",
        "...||||||||||||||||||||||||||||||||||||||||||...",
        "...||||||||||||||||||||||||||||||||||||||||||...",
        "....||||||||||||||||||||||||||||||||||||||||....",
        "....||||||||||||||||||||||||||||||||||||||||....",
        ".....||||||||||||||||||||||||||||||||||||||.....",
        ".....|||||||||||||||||||||||||||||||||||||......",
        "......|||||||||||||||||||||||||||||||||||.......",
        ".......|||||||||||||||||||||||||||||||||........",
        "........|||||||||||||||||||||||||||||||.........",
        "........||||||||||||||||||||||||||||||..........",
        "..........||||||||||||||||||||||||||............",
        "............|||||||||||||||||||||||.............",
        ".............||||||||||||||||||||...............",
        "................|||||||||||||...................",
        "...................||||||.......................",
        "................................................"
      ],
      "terrain": {
        ".": [ [ "t_grass", 75 ], [ "t_dirt", 25 ] ],
        "|": "t_soil",
        "<": "t_earth_ramp_up_low",
        "b": "f_boulder_large",
        ",": "t_dirt"
      }
    }
  }
]
